5 11
###########
# A #D @G #
# #     # #
#   #     #
###########

