5 11
###########
#D  #  @  #
#A#     # #
#   #     #
###########

