5 11
###########
#D  #  @ G#
#A#     # #
#   #D    #
###########

