5 11
###########
#   #  @ G#
#A#     # #
#   #D    #
###########

